5
20
####################
................S##F
.##.###.##.###...##.
.####.######.######.
....................