10
10
S#########
.#####...#
..#....###
....#....#
.#..#.##.#
###.#..#.#
....##.#.#
#.##...#.#
...##.#..#
..#####.F#