6
20
S.########..........
#.##.......########.
#....#####.##....##.
#.##.#.##..##.##.##.
#.##.#.##.###.##...#
..##...##.....####.F
