10
30
.##S#.....####################
....#####.........#######....#
###.#####.#######.#.....#.##.#
................#.##.####.##.#
###.##.########.#.........##.#
.##.##.##.....#.#.##########.#
....##.#####.##.#.....########
.##.##.......##.#######.##.###
###.##########...............#
###.#######....####F##.###.###
